{
  "grid": [
    ["W", "W", "W", "W", "W", "W", "W", "W", "W", "W", "W", "W"],
    ["W", "P", "W", "W", "P", "W", "P", "W", "W", "P", "O", "W"],
    ["W", "G", "W", "P", "G", "W", "G", "W", "P", "W", "W", "W"],
    ["W", "P", "W", "W", "P", "W", "P", "W", "W", "P", "W", "W"],
    ["W", "W", "W", "P", "E", "W", "E", "W", "P", "W", "W", "W"],
    ["W", "P", "W", "W", "P", "W", "P", "W", "W", "P", "W", "W"],
    ["W", "G", "W", "P", "G", "W", "G", "W", "P", "W", "W", "W"],
    ["W", "P", "W", "W", "P", "W", "P", "W", "W", "P", "W", "W"],
    ["W", "W", "W", "P", "L", "W", "E", "W", "P", "P", "W", "W"],
    ["W", "P", "P", "P", "P", "P", "P", "P", "P", "P", "W", "W"],
    ["W", "W", "W", "W", "W", "W", "W", "W", "W", "W", "W", "W"],
    ["W", "W", "W", "W", "W", "W", "W", "W", "W", "W", "W", "W"]
  ],
  "start": { "x": 1, "y": 10 }
}