{
  "grid": [
    ["W", "W", "W", "W", "W", "W", "W", "W", "W", "W", "W", "W"],
    ["W", "P", "W", "W", "P", "W", "W", "P", "W", "W", "O", "W"],
    ["W", "L", "W", "P", "G", "W", "P", "G", "W", "P", "W", "W"],
    ["W", "P", "W", "W", "P", "W", "W", "P", "W", "W", "P", "W"],
    ["W", "W", "W", "P", "E", "W", "P", "E", "W", "P", "W", "W"],
    ["W", "P", "W", "W", "P", "W", "W", "P", "W", "W", "P", "W"],
    ["W", "G", "W", "P", "G", "W", "P", "G", "W", "P", "W", "W"],
    ["W", "P", "W", "W", "P", "W", "W", "P", "W", "W", "P", "W"],
    ["W", "W", "W", "P", "L", "W", "E", "W", "P", "W", "W", "W"],
    ["W", "P", "P", "P", "P", "P", "P", "P", "P", "P", "W", "W"],
    ["W", "W", "W", "W", "W", "W", "W", "W", "W", "W", "W", "W"],
    ["W", "W", "W", "W", "W", "W", "W", "W", "W", "W", "W", "W"]
  ],
  "start": { "x": 1, "y": 10 }
}